1111111111
1PE0000C11
111111111
