11111111111111111
1CCCCCCCCCCCCCCC1
1CCCCCCCCCCCCCCC1
1CPCCCCCCCCCCECC1
11111111111111111
