111111111111111111
1100CEP0CCCCC0CCC1
11000000CCCCCCCC11
111111111111111111






