11111111111111111
1C000000000000001
1000000C000000001
10P00000000000001
10000000000000001
10000000000E00001
11111111111111111
