11111111111111111
10000000000000001
10000000000000001
10P110000C0000001
100000C0000000001
10000000000E00001
11111111111111111
