11111111111111111
1C000000000000001
1000000C0000000001
10P0000C0C00000001
1000000C000000001
100000C0000E00001
11111111111111111