11111111111111111
10000000000000001
10000111100000001
10P000000C0000001
10000010001000001
10000000010E00001
11111111111111111
