11111111111111111
10000000000000001
10000000000000001
10P000111C0000001
1000001E100000001
10000011100100001
11111111111111111
