11111111111111111
10000000000000001
10000000000000001
10P000111C0000001
1000001C100000001
10000011100E00001
11111111111111111
