11111111111111111
1C000100000000001
1000110C000000001
10P0000C0C0000001
1000100C000000001
100100C0000E00001
11111111111111111
