1111111111
1P0E00C011
1111111111