1111111111
1P0E10C011
1111111111